########################
#                 ###  #
#                 ###  #
#                 ###  #
#   ###           ###  #
#   ###    R      ###  #
#   ###           ###  #
#   ###           ###  #
#                 ###  #
#                 ###  #
#      #########  ###  #
#      #########       #
#      #########       #
#                      #
#                      #
#                      #
##########   ###########